10
10              
0 0 5 4 1 2 3 4 0 4
0 0 1 4 1 2 3 4 0 4
0 0 1 0 1 1 3 0 0 4
5 1 1 5 1 1 3 0 0 4
5 0 2 5 1 1 3 0 0 4
5 2 0 3 1 1 3 0 0 4
5 3 0 3 1 2 3 0 0 4
0 4 0 0 1 2 3 4 0 4
0 2 0 4 1 2 3 4 0 4
0 2 0 4 1 2 3 4 0 4